###############
#PDDDDDDDDDDDP#
#DXXXXXXXXXXXD#
#DXXXXXXXXXXXD#
#DXXXXXXXXXXXD#
#DXXXXXXXXXXXD#
#DXXXXXXXXXXXD#
#DXXXXXXXXXXXD#
#DXXXXXXXXXXXD#
#DXXXXXXXXXXXD#
#DXXXXXXXXXXXD#
#DXXXXXXXXXXXD#
#PDDDDDDDDDDDP#
###############